肯泰罗-帕底亚的样子-火	朱	Tauros-2	Scarlet
幼基拉斯	朱	Larvitar	Scarlet
沙基拉斯	朱	Pupitar	Scarlet
班基拉斯	朱	Tyranitar	Scarlet
飘飘球	朱	Drifloon	Scarlet
随风球	朱	Drifblim	Scarlet
臭鼬噗	朱	Stunky	Scarlet
坦克臭鼬	朱	Skuntank	Scarlet
单首龙	朱	Deino	Scarlet
双首暴龙	朱	Zweilous	Scarlet
三首恶龙	朱	Hydreigon	Scarlet
垃垃藻	朱	Skrelp	Scarlet
毒藻龙	朱	Dragalge	Scarlet
智挥猩	朱	Oranguru	Scarlet
巨石丁	朱	Stonjourner	Scarlet
雄伟牙	朱	Great Tusk	Scarlet
猛恶菇	朱	Brute Bonnet	Scarlet
沙铁皮	朱	Sandy Shocks	Scarlet
吼叫尾	朱	Scream Tail	Scarlet
振翼发	朱	Flutter Mane	Scarlet
爬地翅	朱	Slither Wing	Scarlet
轰鸣月	朱	Roaring Moon	Scarlet
红莲铠骑	朱	Armarouge	Scarlet
肯泰罗-帕底亚的样子-水	紫	Tauros-3	Violet
梦妖	紫	Misdreavus	Violet
溶食兽	紫	Gulpin	Violet
吞食兽	紫	Swalot	Violet
宝贝龙	紫	Bagon	Violet
甲壳龙	紫	Shelgon	Violet
暴飞龙	紫	Salamence	Violet
梦妖魔	紫	Mismagius	Violet
铁臂枪虾	紫	Clauncher	Violet
钢炮臂虾	紫	Clawitzer	Violet
投掷猴	紫	Passimian	Violet
冰砌鹅	紫	Eiscue	Violet
多龙梅西亚	紫	Dreepy	Violet
多龙奇	紫	Drakloak	Violet
多龙巴鲁托	紫	Dragapult	Violet
铁辙迹	紫	Iron Treads	Violet
铁毒蛾	紫	Iron Moth	Violet
铁臂膀	紫	Iron Hands	Violet
铁脖颈	紫	Iron Jugulis	Violet
铁荆棘	紫	Iron Thorns	Violet
铁包袱	紫	Iron Bundle	Violet
铁武者	紫	Iron Valiant	Violet
苍炎刃鬼	紫	Ceruledge	Violet
